.........................#####
.####....................#####
.####..........#####..........
...............#####..........
...............#####..........
......................#.......
......................#.......
...........#####......#.......
...........#####............#.
...........#####............#.
...........#####............#.
..............................
#####......................###
#####......................###
...........#####............#.
...........#####............#.
......................#.......
......................#.......
...............#####..........
.####..........#####..........
