#########################
#.....A.....####...B....#
#..###.###..#..#...#..#.#
#..#.....#..#..#...#..#.#
#..#.###.#..####...#..#.#
#..#.#X#.#..........#..#.#
#..#.#.#.#######.#####.##
#..#.#.#.....D.#....D...#
#..#.###.#####.##########
#..#.....#...#..........#
#..#######.###.#######..#
#...............C.....T.#
#########################
