.........................
..#####..................
..#......................
..#.....#####............
..#......................
..#######................
.....................####
......................#..
......................#..
......................#..
......................#..
.........................
